11111111111111111111111111111111111111111
13030303030300303030300030303030030303031
10303030303030300030303030300030303030301
13030300303030303030303000303030303030331
10303030300030303000303030303030300030301
13030030303030303030300030303030303030331
10303000303030300030303030300030303030301
13030303030303030303030303030303030303031
10303030303000303030303030300030303030301
13030030030303030303030303030303003000321
11111111111111111111111111111111111111111
