11111111111111111111111111111111111
10000003300000000000000000000000001
10100003300100000001010000010003001
10111010111010101010111011111011101
10001010000010101000101000101000101
11101011111111101011101110101011101
10001010000033001000030010100000001
10111111101111111110101110101011101
10003010001010001000100003001330101
10111010111010111110111110111011101
10001000100000000000100000001210001
11111001111111110111110011111111111
10000000000000000333000000030000001
10111011101111011101111011101111001
11111111111111111111111111111111111
