11111
10401
10301
10021
11111
